~~~~~~~~~~
~~S$a~~~~~
~~~$#~~~~~
~~~$$~~~~~
aaaa$~~~~~
~~~~~~~~~~
~~~~~~~~~~
~~~~~~~~~~
~~~~~~~~~~
~~~~~~~~~~